NO images/antonio.png
SO images/antonyo.png
WE images/sensein't.png
EA images/nestor.png

C 60,65,88
F 0,158,65

         1111111111111111111111111
        10000000001 100000000000001
        10110000011 110000000000001111111
        1001000000010000000000001111
    11111111011000001110000000000001
   100000000011000001110111111101111
11110111111111011100000010001  1
11110111111111011101010010001
11000000110101011100000010001
100010001000000011000000100011111111
1001 10N100000001101010010001
1100100111010101111101111000111
11110111 10110101 11111010001
11111111 1111111 111111111111